

Run Date,Action,Symbol,Description,Type,Exchange Quantity,Exchange Currency,Quantity,Currency,Price,Exchange Rate,Commission,Fees,Accrued Interest,Amount,Cash Balance,Settlement Date
 03/11/2025," YOU BOUGHT NVIDIA CORPORATION COM (NVDA) (Cash)", NVDA," NVIDIA CORPORATION COM",Cash,0,,1,USD,106.98,0,,,,-106.98,2060.81,03/12/2025
 03/11/2025," YOU BOUGHT INTUITIVE MACHINES INC CLASS A COM (LUNR) (Cash)", LUNR," INTUITIVE MACHINES INC CLASS A COM",Cash,0,,15,USD,6.69,0,,,,-100.35,2167.79,03/12/2025
 03/04/2025," YOU BOUGHT INTUITIVE MACHINES INC CLASS A COM (LUNR) (Cash)", LUNR," INTUITIVE MACHINES INC CLASS A COM",Cash,0,,5,USD,13.03,0,,,,-65.16,0.14,03/05/2025
 03/04/2025," YOU BOUGHT PROSPECTUS UNDER SEPARATE COVER FIDELITY 500 INDEX FUND (FXAIX) (Cash)", FXAIX," FIDELITY 500 INDEX FUND",Cash,0,,0.03,USD,201.02,0,,,,-6,65.30,03/05/2025
 03/04/2025," YOU BOUGHT CAVA GROUP INC COM (CAVA) (Cash)", CAVA," CAVA GROUP INC COM",Cash,0,,1,USD,85.12,0,,,,-85.12,71.30,03/05/2025
 02/27/2025," YOU BOUGHT CAVA GROUP INC COM (CAVA) (Cash)", CAVA," CAVA GROUP INC COM",Cash,0,,1,USD,90.79,0,,,,-90.79,109.21,02/28/2025
 02/26/2025," YOU BOUGHT WALMART INC COM (WMT) (Cash)", WMT," WALMART INC COM",Cash,0,,1,USD,97.97,0,,,,-97.97,200.00,02/27/2025
 02/26/2025," YOU BOUGHT REDDIT INC CL A (RDDT) (Cash)", RDDT," REDDIT INC CL A",Cash,0,,1,USD,162,0,,,,-162,297.97,02/27/2025
 02/26/2025," YOU BOUGHT NVIDIA CORPORATION COM (NVDA) (Cash)", NVDA," NVIDIA CORPORATION COM",Cash,0,,1,USD,129.59,0,,,,-129.59,459.97,02/27/2025
 02/26/2025," YOU BOUGHT MICROSOFT CORP (MSFT) (Cash)", MSFT," MICROSOFT CORP",Cash,0,,1,USD,395.12,0,,,,-395.12,589.56,02/27/2025
 02/26/2025," YOU BOUGHT JPMORGAN CHASE &CO. COM (JPM) (Cash)", JPM," JPMORGAN CHASE &CO. COM",Cash,0,,1,USD,257.22,0,,,,-257.22,984.68,02/27/2025
 02/26/2025," YOU BOUGHT PROSPECTUS UNDER SEPARATE COVER FIDELITY 500 INDEX FUND (FXAIX) (Cash)", FXAIX," FIDELITY 500 INDEX FUND",Cash,0,,1.072,USD,207.16,0,,,,-222.16,1241.90,02/27/2025
 02/26/2025," YOU BOUGHT CAVA GROUP INC COM (CAVA) (Cash)", CAVA," CAVA GROUP INC COM",Cash,0,,1,USD,100.74,0,,,,-100.74,1464.06,02/27/2025
 02/26/2025," YOU BOUGHT APPLE INC (AAPL) (Cash)", AAPL," APPLE INC",Cash,0,,1,USD,243.99,0,,,,-243.99,1564.80,02/27/2025
 02/26/2025," YOU BOUGHT ALPHABET INC CAP STK CL C (GOOG) (Cash)", GOOG," ALPHABET INC CAP STK CL C",Cash,0,,1,USD,176.55,0,,,,-176.55,1808.79,02/27/2025
 02/25/2025," YOU BOUGHT NVIDIA CORPORATION COM (NVDA) (Cash)", NVDA," NVIDIA CORPORATION COM",Cash,0,,1,USD,129.99,0,,,,-129.99,1985.34,02/26/2025
 02/25/2025," YOU BOUGHT APPLE INC (AAPL) (Cash)", AAPL," APPLE INC",Cash,0,,1,USD,247.97,0,,,,-247.97,2115.33,02/26/2025
 02/25/2025," YOU BOUGHT ALPHABET INC CAP STK CL C (GOOG) (Cash)", GOOG," ALPHABET INC CAP STK CL C",Cash,0,,1,USD,180.07,0,,,,-180.07,2363.30,02/26/2025
 02/24/2025," YOU BOUGHT WALMART INC COM (WMT) (Cash)", WMT," WALMART INC COM",Cash,0,,1,USD,94.11,0,,,,-94.11,2176.97,02/25/2025
 02/24/2025," YOU BOUGHT REDDIT INC CL A (RDDT) (Cash)", RDDT," REDDIT INC CL A",Cash,0,,1,USD,166.09,0,,,,-166.09,2271.08,02/25/2025
 02/24/2025," YOU SOLD PALANTIR TECHNOLOGIES INC CL A (PLTR) (Cash)", PLTR," PALANTIR TECHNOLOGIES INC CL A",Cash,0,,-18,USD,96.35,0,,0.05,,1734.25,2437.17,02/25/2025
 02/24/2025," YOU BOUGHT PROSPECTUS UNDER SEPARATE COVER FIDELITY 500 INDEX FUND (FXAIX) (Cash)", FXAIX," FIDELITY 500 INDEX FUND",Cash,0,,1.201,USD,208.1,0,,,,-250,702.92,02/25/2025
 02/24/2025," YOU BOUGHT AMAZON.COM INC (AMZN) (Cash)", AMZN," AMAZON.COM INC",Cash,0,,1,USD,215.76,0,,,,-215.76,952.92,02/25/2025
 02/21/2025," YOU BOUGHT WALMART INC COM (WMT) (Cash)", WMT," WALMART INC COM",Cash,0,,2,USD,94.75,0,,,,-189.5,1154.68,02/24/2025
 02/21/2025," YOU BOUGHT REDDIT INC CL A (RDDT) (Cash)", RDDT," REDDIT INC CL A",Cash,0,,1,USD,165.25,0,,,,-165.25,1344.18,02/24/2025
 02/21/2025," YOU BOUGHT NVIDIA CORPORATION COM (NVDA) (Cash)", NVDA," NVIDIA CORPORATION COM",Cash,0,,1,USD,134.84,0,,,,-134.84,1509.43,02/24/2025
 02/21/2025," YOU BOUGHT INTUITIVE MACHINES INC CLASS A COM (LUNR) (Cash)", LUNR," INTUITIVE MACHINES INC CLASS A COM",Cash,0,,5,USD,18.02,0,,,,-90.1,1644.27,02/24/2025
 02/21/2025," YOU BOUGHT PROSPECTUS UNDER SEPARATE COVER FIDELITY 500 INDEX FUND (FXAIX) (Cash)", FXAIX," FIDELITY 500 INDEX FUND",Cash,0,,1.195,USD,209.13,0,,,,-250,1734.37,02/24/2025
 02/21/2025," YOU BOUGHT PROSPECTUS UNDER SEPARATE COVER FIDELITY 500 INDEX FUND (FXAIX) (Cash)", FXAIX," FIDELITY 500 INDEX FUND",Cash,0,,1.195,USD,209.13,0,,,,-250,1984.37,02/24/2025
 02/21/2025," YOU BOUGHT CAVA GROUP INC COM (CAVA) (Cash)", CAVA," CAVA GROUP INC COM",Cash,0,,1,USD,108.78,0,,,,-108.78,2234.37,02/24/2025
 02/21/2025," YOU BOUGHT AMAZON.COM INC (AMZN) (Cash)", AMZN," AMAZON.COM INC",Cash,0,,1,USD,215.83,0,,,,-215.83,2343.15,02/24/2025
 02/20/2025," YOU BOUGHT WALMART INC COM (WMT) (Cash)", WMT," WALMART INC COM",Cash,0,,2,USD,97.34,0,,,,-194.68,2558.98,02/21/2025
 02/20/2025," YOU BOUGHT REDDIT INC CL A (RDDT) (Cash)", RDDT," REDDIT INC CL A",Cash,0,,1,USD,174.19,0,,,,-174.19,2753.66,02/21/2025
 02/20/2025," YOU BOUGHT PALANTIR TECHNOLOGIES INC CL A (PLTR) (Cash)", PLTR," PALANTIR TECHNOLOGIES INC CL A",Cash,0,,3,USD,102.5,0,,,,-307.5,2927.85,02/21/2025
 02/20/2025," YOU BOUGHT NVIDIA CORPORATION COM (NVDA) (Cash)", NVDA," NVIDIA CORPORATION COM",Cash,0,,1,USD,140,0,,,,-140,3235.35,02/21/2025
 02/20/2025," YOU BOUGHT JPMORGAN CHASE &CO. COM (JPM) (Cash)", JPM," JPMORGAN CHASE &CO. COM",Cash,0,,1,USD,278.73,0,,,,-278.73,3375.35,02/21/2025
 02/20/2025," YOU BOUGHT INTUITIVE MACHINES INC CLASS A COM (LUNR) (Cash)", LUNR," INTUITIVE MACHINES INC CLASS A COM",Cash,0,,5,USD,19.58,0,,,,-97.9,3654.08,02/21/2025
 02/20/2025," YOU BOUGHT PROSPECTUS UNDER SEPARATE COVER FIDELITY 500 INDEX FUND (FXAIX) (Cash)", FXAIX," FIDELITY 500 INDEX FUND",Cash,0,,1.011,USD,212.75,0,,,,-215,3751.98,02/21/2025
 02/20/2025," YOU BOUGHT CAVA GROUP INC COM (CAVA) (Cash)", CAVA," CAVA GROUP INC COM",Cash,0,,1,USD,118.78,0,,,,-118.78,3966.98,02/21/2025
 02/20/2025," YOU BOUGHT AMAZON.COM INC (AMZN) (Cash)", AMZN," AMAZON.COM INC",Cash,0,,1,USD,222.25,0,,,,-222.25,4085.76,02/21/2025
 02/19/2025," YOU BOUGHT REDDIT INC CL A (RDDT) (Cash)", RDDT," REDDIT INC CL A",Cash,0,,1,USD,186.01,0,,,,-186.01,4308.01,02/20/2025
 02/19/2025," YOU BOUGHT NVIDIA CORPORATION COM (NVDA) (Cash)", NVDA," NVIDIA CORPORATION COM",Cash,0,,1,USD,139.45,0,,,,-139.45,4494.02,02/20/2025
 02/19/2025," YOU BOUGHT META PLATFORMS INC CLASS A COMMON STOCK (META) (Cash)", META," META PLATFORMS INC CLASS A COMMON STOCK",Cash,0,,1,USD,704.36,0,,,,-704.36,4633.47,02/20/2025
 02/19/2025," YOU BOUGHT CAVA GROUP INC COM (CAVA) (Cash)", CAVA," CAVA GROUP INC COM",Cash,0,,1,USD,131.36,0,,,,-131.36,5337.83,02/20/2025
 02/19/2025," YOU BOUGHT APPLE INC (AAPL) (Cash)", AAPL," APPLE INC",Cash,0,,1,USD,244.69,0,,,,-244.69,5469.19,02/20/2025
 02/19/2025," YOU BOUGHT AMAZON.COM INC (AMZN) (Cash)", AMZN," AMAZON.COM INC",Cash,0,,1,USD,225.44,0,,,,-225.44,5713.88,02/20/2025
 02/19/2025," YOU BOUGHT ALPHABET INC CAP STK CL C (GOOG) (Cash)", GOOG," ALPHABET INC CAP STK CL C",Cash,0,,2,USD,186.22,0,,,,-372.44,5939.32,02/20/2025
 02/18/2025," YOU BOUGHT PROSPECTUS UNDER SEPARATE COVER FIDELITY 500 INDEX FUND (FXAIX) (Cash)", FXAIX," FIDELITY 500 INDEX FUND",Cash,0,,2.346,USD,213.14,0,,,,-500,6311.76,02/19/2025
 02/03/2025," YOU BOUGHT NVIDIA CORPORATION COM (NVDA) (Cash)", NVDA," NVIDIA CORPORATION COM",Cash,0,,1,USD,113.92,0,,,,-113.92,-88.63,02/04/2025
 02/03/2025," YOU BOUGHT INTUITIVE MACHINES INC CLASS A COM (LUNR) (Cash)", LUNR," INTUITIVE MACHINES INC CLASS A COM",Cash,0,,5,USD,20.4,0,,,,-101.99,25.29,02/04/2025
 02/03/2025," YOU BOUGHT PROSPECTUS UNDER SEPARATE COVER FIDELITY 500 INDEX FUND (FXAIX) (Cash)", FXAIX," FIDELITY 500 INDEX FUND",Cash,0,,1.2,USD,208.29,0,,,,-250,127.28,02/04/2025
 01/31/2025," YOU BOUGHT NVIDIA CORPORATION COM (NVDA) (Cash)", NVDA," NVIDIA CORPORATION COM",Cash,0,,1,USD,123.43,0,,,,-123.43,288.06,02/03/2025
 01/31/2025," YOU BOUGHT PROSPECTUS UNDER SEPARATE COVER FIDELITY 500 INDEX FUND (FXAIX) (Cash)", FXAIX," FIDELITY 500 INDEX FUND",Cash,0,,1.191,USD,209.87,0,,,,-250,411.49,02/03/2025
 01/28/2025," YOU BOUGHT PROSPECTUS UNDER SEPARATE COVER FIDELITY 500 INDEX FUND (FXAIX) (Cash)", FXAIX," FIDELITY 500 INDEX FUND",Cash,0,,0.474,USD,210.8,0,,,,-100,661.49,01/29/2025
 01/27/2025," YOU BOUGHT REDDIT INC CL A (RDDT) (Cash)", RDDT," REDDIT INC CL A",Cash,0,,0.784,USD,175.87,0,,,,-137.88,661.49,01/28/2025
 01/27/2025," YOU BOUGHT PALANTIR TECHNOLOGIES INC CL A (PLTR) (Cash)", PLTR," PALANTIR TECHNOLOGIES INC CL A",Cash,0,,2,USD,75.01,0,,,,-150.02,799.37,01/28/2025
 01/27/2025," YOU BOUGHT PALANTIR TECHNOLOGIES INC CL A (PLTR) (Cash)", PLTR," PALANTIR TECHNOLOGIES INC CL A",Cash,0,,2,USD,75.25,0,,,,-150.5,949.39,01/28/2025
 01/27/2025," YOU BOUGHT PALANTIR TECHNOLOGIES INC CL A (PLTR) (Cash)", PLTR," PALANTIR TECHNOLOGIES INC CL A",Cash,0,,1,USD,73.18,0,,,,-73.18,1099.89,01/28/2025
 01/27/2025," YOU BOUGHT NVIDIA CORPORATION COM (NVDA) (Cash)", NVDA," NVIDIA CORPORATION COM",Cash,0,,2,USD,127.47,0,,,,-254.95,1173.07,01/28/2025
 01/27/2025," YOU BOUGHT NVIDIA CORPORATION COM (NVDA) (Cash)", NVDA," NVIDIA CORPORATION COM",Cash,0,,1,USD,118.47,0,,,,-118.47,1428.02,01/28/2025
 01/27/2025," YOU BOUGHT NVIDIA CORPORATION COM (NVDA) (Cash)", NVDA," NVIDIA CORPORATION COM",Cash,0,,1,USD,120.09,0,,,,-120.09,1546.49,01/28/2025
 01/27/2025," YOU BOUGHT NVIDIA CORPORATION COM (NVDA) (Cash)", NVDA," NVIDIA CORPORATION COM",Cash,0,,1,USD,121.41,0,,,,-121.41,1666.58,01/28/2025
 01/27/2025," YOU BOUGHT MICROSOFT CORP (MSFT) (Cash)", MSFT," MICROSOFT CORP",Cash,0,,1,USD,429.3,0,,,,-429.3,1787.99,01/28/2025
 01/27/2025," YOU BOUGHT INTUITIVE MACHINES INC CLASS A COM (LUNR) (Cash)", LUNR," INTUITIVE MACHINES INC CLASS A COM",Cash,0,,5,USD,22.05,0,,,,-110.25,2217.29,01/28/2025
 01/27/2025," YOU BOUGHT INTUITIVE MACHINES INC CLASS A COM (LUNR) (Cash)", LUNR," INTUITIVE MACHINES INC CLASS A COM",Cash,0,,3,USD,21.53,0,,,,-64.59,2327.54,01/28/2025
 01/27/2025," YOU BOUGHT INTUITIVE MACHINES INC CLASS A COM (LUNR) (Cash)", LUNR," INTUITIVE MACHINES INC CLASS A COM",Cash,0,,2,USD,21.03,0,,,,-42.07,2392.13,01/28/2025
 01/27/2025," YOU BOUGHT PROSPECTUS UNDER SEPARATE COVER FIDELITY 500 INDEX FUND (FXAIX) (Cash)", FXAIX," FIDELITY 500 INDEX FUND",Cash,0,,1.197,USD,208.87,0,,,,-250,2434.20,01/28/2025
 01/27/2025," YOU BOUGHT META PLATFORMS INC CLASS A COMMON STOCK (META) (Cash)", META," META PLATFORMS INC CLASS A COMMON STOCK",Cash,0,,1,USD,634.83,0,,,,-634.83,2684.20,01/28/2025
 01/27/2025," YOU BOUGHT CAVA GROUP INC COM (CAVA) (Cash)", CAVA," CAVA GROUP INC COM",Cash,0,,1,USD,124.06,0,,,,-124.06,3319.03,01/28/2025
 01/27/2025," YOU BOUGHT APPLE INC (AAPL) (Cash)", AAPL," APPLE INC",Cash,0,,1,USD,224.12,0,,,,-224.12,3443.09,01/28/2025
 01/27/2025," YOU BOUGHT AMAZON.COM INC (AMZN) (Cash)", AMZN," AMAZON.COM INC",Cash,0,,1,USD,226.27,0,,,,-226.27,3667.21,01/28/2025
 01/27/2025," YOU BOUGHT ALPHABET INC CAP STK CL C (GOOG) (Cash)", GOOG," ALPHABET INC CAP STK CL C",Cash,0,,1,USD,195.15,0,,,,-195.15,3893.48,01/28/2025
 01/22/2025," YOU BOUGHT PALANTIR TECHNOLOGIES INC CL A (PLTR) (Cash)", PLTR," PALANTIR TECHNOLOGIES INC CL A",Cash,0,,1,USD,74.57,0,,,,-74.57,4082.63,01/23/2025
 01/14/2025," YOU BOUGHT PROSPECTUS UNDER SEPARATE COVER FIDELITY 500 INDEX FUND (FXAIX) (Cash)", FXAIX," FIDELITY 500 INDEX FUND",Cash,0,,0.708,USD,202.93,0,,,,-143.59,0.00,01/15/2025
 01/07/2025," YOU BOUGHT WALMART INC COM (WMT) (Cash)", WMT," WALMART INC COM",Cash,0,,1,USD,91.7,0,,,,-91.7,41.59,01/08/2025
 01/07/2025," YOU BOUGHT PALANTIR TECHNOLOGIES INC CL A (PLTR) (Cash)", PLTR," PALANTIR TECHNOLOGIES INC CL A",Cash,0,,1,USD,72.13,0,,,,-72.13,133.29,01/08/2025
 01/07/2025," YOU BOUGHT PALANTIR TECHNOLOGIES INC CL A (PLTR) (Cash)", PLTR," PALANTIR TECHNOLOGIES INC CL A",Cash,0,,1,USD,75.03,0,,,,-75.03,205.42,01/08/2025
 01/07/2025," YOU BOUGHT NVIDIA CORPORATION COM (NVDA) (Cash)", NVDA," NVIDIA CORPORATION COM",Cash,0,,1,USD,144.93,0,,,,-144.93,280.45,01/08/2025
 01/07/2025," YOU BOUGHT NVIDIA CORPORATION COM (NVDA) (Cash)", NVDA," NVIDIA CORPORATION COM",Cash,0,,1,USD,153.1,0,,,,-153.1,425.38,01/08/2025
 01/07/2025," YOU BOUGHT INTUITIVE MACHINES INC CLASS A COM (LUNR) (Cash)", LUNR," INTUITIVE MACHINES INC CLASS A COM",Cash,0,,5,USD,20.84,0,,,,-104.2,578.48,01/08/2025
 01/07/2025," YOU BOUGHT PROSPECTUS UNDER SEPARATE COVER FIDELITY 500 INDEX FUND (FXAIX) (Cash)", FXAIX," FIDELITY 500 INDEX FUND",Cash,0,,1.218,USD,205.18,0,,,,-250,682.68,01/08/2025
 01/07/2025," YOU BOUGHT CAVA GROUP INC COM (CAVA) (Cash)", CAVA," CAVA GROUP INC COM",Cash,0,,1,USD,112.68,0,,,,-112.68,932.68,01/08/2025
 01/06/2025," YOU BOUGHT PALANTIR TECHNOLOGIES INC CL A (PLTR) (Cash)", PLTR," PALANTIR TECHNOLOGIES INC CL A",Cash,0,,2,USD,78.7,0,,,,-157.4,1028.80,01/07/2025



"The data and information in this spreadsheet is provided to you solely for your use and is not for distribution. The spreadsheet is provided for"
"informational purposes only, and is not intended to provide advice, nor should it be construed as an offer to sell, a solicitation of an offer to buy or a"
"recommendation for any security or insurance product by Fidelity or any third party. Data and information shown is based on information known to Fidelity as of the date it was"
"exported and is subject to change. It should not be used in place of your account statements or trade confirmations and is not intended for tax reporting"
"purposes. For more information on the data included in this spreadsheet, including any limitations thereof, go to Fidelity.com."

"Brokerage services are provided by Fidelity Brokerage Services LLC (FBS), 900 Salem Street, Smithfield, RI 02917. Custody and other services provided by National"
"Financial Services LLC (NFS). Both are Fidelity Investment companies and members SIPC, NYSE. Insurance products at Fidelity are distributed by"
"Fidelity Insurance Agency, Inc., and, for certain products, by Fidelity Brokerage Services, Member NYSE, SIPC."

Date downloaded 03/14/2025 7:40 am